1111111111111111111111
1E111111111C0000111111
10000C00011111000000C1
1111110000000000111111
10000C00000000000000P1
1111111111111111111111
